6 6 6 4 4 4 6 4 4 4
6 0 6 4 6 4 6 4 6 4
6 1 6 4 4 3 4 3 4 4
6 4 3 6 6 4 6 4 6 6
6 3 3 4 4 3 6 4 6 6
6 3 3 4 6 4 6 4 6 6
6 4 3 4 4 4 4 3 4 4
6 4 6 6 6 6 6 4 6 6
2 3 3 3 3 3 4 3 4 6
6 6 3 3 3 3 6 4 4 6